############################################################
## · · · · · · · · · · · · · · · · · · · · · · · · · · · ##
## · ####### · ######### · ##### · ######### · ####### · ##
## · ####### · ######### · ##### · ######### · ####### · ##
## · · · · · · · · · · · · · · · · · · · · · · · · · · · ##
## · ############# · ################# · ############# · ##
## · · · · · · ### · · · · ##### · · · · ### · · · · · · ##
############ · ######### · ##### · ######### · ############
         ### · ### · · · · · · · · · · · ### · ###
         ### · ### · ######-----###### · ### · ###
############ · ### · #               # · ### · ############
 · · · · · · · · · · #               # · · · · · · · · · ·
############ · ### · #               # · ### · ############
         ### · ### · ################# · ### · ###
         ### · ### · · · · · · · · · · · ### · ###
############ · ### · ################# · ### · ############
## · · · · · · · · · · · · ##### · · · · · · · · · · · · ##
## · ####### · ######### · ##### · ######### · ####### · ##
## · · · ### · · · · · · · · · · · · · · · · · ### · · · ##
###### · ### · ### · ################# · ### · ### · ######
## · · · · · · ### · · · · ##### · · · · ### · · · · · · ##
## · ################### · ##### · ################### · ##
## · · · · · · · · · · · · · · · · · · · · · · · · · · · ##
###########################################################
