████████████████████████████████████████████████████████████
██                         █████                         ██
██   ███████   █████████   █████   █████████   ███████   ██
██   ███████   █████████   █████   █████████   ███████   ██
██                                                       ██
██   █████████████   █████████████████   █████████████   ██
██             ███         █████         ███             ██
████████████   █████████   █████   █████████   ████████████
         ███   ███                       ███   ███         
         ███   ███   ██████-----██████   ███   ███         
████████████   ███   █               █   ███   ████████████
                     █               █                     
████████████   ███   █               █   ███   ████████████
         ███   ███   █████████████████   ███   ███         
         ███   ███                       ███   ███         
████████████   ███   █████████████████   ███   ████████████
██                         █████                         ██
██   ███████   █████████   █████   █████████   ███████   ██
██       ███                 · · · · · · · · · ███       ██
██████   ███   ███   █████████████████   ███   ███   ██████
██             ███         █████         ███             ██
██   ███████████████████   █████   ███████████████████   ██
██                                                       ██
███████████████████████████████████████████████████████████