############################################################
##                                                       ##
##   #######   #########   #####   #########   #######   ##
##   #######   #########   #####   #########   #######   ##
##                                                       ##
##   #############   #################   #############   ##
##             ###         #####         ###             ##
############   #########   #####   #########   ############
         ###   ###                       ###   ###
         ###   ###   ######-----######   ###   ###
############   ###   #               #   ###   ############
                     #               #
############   ###   #               #   ###   ############
         ###   ###   #################   ###   ###
         ###   ###                       ###   ###
############   ###   #################   ###   ############
##                         #####                         ##
##   #######   #########   #####   #########   #######   ##
##       ###                                   ###       ##
######   ###   ###   #################   ###   ###   ######
##             ###         #####         ###             ##
##   ###################   #####   ###################   ##
##                                                       ##
###########################################################
